         B
        BB            BB
       BBB            BBBB
      BBBBP           BBBB
      BBBB           OBBBBBB
BBBBBBBBBB     B B   BBBBBBBBBBB
BBBBBBBBBB    B      BBBBBBBBBB
BBBBBBBBBBS  BO      OBBBBBBBBBB
BBBBBBBBBBBBBBBBBBBBBBBBBBBBBBBB
BBBBBBBBBBBBBBBBBBBBBBBBBBBBBBBB
BBBBBBBBBBBBBBBBBBBBBBBBBBBBBBBB
BBBBBBBBBBBBBBBBBBBBBBBBBBBBBBBB
BBBBBBBBBBBBBBBBBBBBBBBBBBBBBBBB