BBBBBBBBBBBBBB
BP          SB
B         FBBB
BB           B
BO        B OB
BBBBBBBBBBBBBB