         B           BB
        BB          OBBB
BBBBBBBBBB          BBBBBBBBBBB
BBBBBBBBBB   B      BBBBBBBBBBB
BBBBBBBBBBS  B      BBBBBBBBBBB
BBBBBBBBBBBBBBBBBBBBBBBBBBBBBBB
BBBBBBBBBBBBBBBBBBBBBBBBBBBBBBB
BBBBBBBBBBBBBBBBBBBBBBBBBBBBBBB
BBBBBBBBBBBBBBBBBBBBBBBBBBBBBBB
BBBBBBBBBBBBBBBBBBBBBBBBBBBBBBB